                                                                                                                                                              
                                                             █████ ███████ ███████████ █████████████                                                          
                                                            █.....█.......█...........█.............█                                                         
                                                            █.███.███.███.█.█████████.█.█████.█████.█                                                         
                                                            █...█.....█...█.█...█...█.█.█...█.█.....█                                                         
                                                             ██.███████.███.█.███.█.█.███.█.█.█.████                                                          
                                                            █...█.......█...█.....█...█...█...█...█.█                                                         
                                                            █.██ ████████.█.███████.███.█████████.█.█                                                         
                                                            █...█.........█.█.....█.█...█......☺█.█.█                                                         
                                                            █.█.█.█████.█████.███.█.███.█.█.█████.█.█                                                         
                                                            █.█.█.█.....█.....█...█.....█.█.......█.█                                                         
                                                             ██.█.█.█████.█████.█████████.█████████.█                                                         
                                                            █...█.█.█...█...█.█.....█.....█.........█                                                         
                                                            █.█.█.███.█.███.█.█████.███.███.███████.█                                                         
                                                            █.█.█.....█...█.█.....█...█.█.........█.█                                                         
                                                            █.████████ ██.█.█.███.███.█.█████.███.█.█                                                         
                                                            █.....█...█...█.█.█.....█.█.....█.█...█.█                                                         
                                                             ██.█.█.█.█.███.███.███.█.█████.█.█.████                                                          
                                                            █...█.█.█.█.....█...█...█...█.█.█.█.....█                                                         
                                                            █.█████.█.███████.█████.███.█.█.█.█████.█                                                         
                                                            █.......█...█.....█...█...█.█...█...█.█.█                                                         
                                                            █.█████.█.█.█████.█.█.█.███.█.█████.█.█.█                                                         
                                                            █.█...█.█.█.█.....█.█.█.█...█.█.......█.█                                                         
                                                            █.█.█.███.█.█.███████.█.█.███.█████████.█                                                         
                                                            █.█.█.....█.█...█.....█.█.█.........█...█                                                         
                                                            █.█.███████.███.█.█████.█.█████████.█.█.█                                                         
                                                            █.█.....█.......█.█...█.█...█...█.....█.█                                                         
                                                            █.█████.███████.█.█.███.███.█.█.███████.█                                                         
                                                            █.█.█...█...█...█.█.......█...█.....█...█                                                         
                                                            █.█.█.█.█.█.███.█.█.█████.█████████.█.██                                                          
                                                            █...█.█.█.█...█.█.█.█...█.█.█.....█.█.█.█                                                         
                                                             ██.█.█.█.███.███.███.█.█.█.█.███.█.█.█.█                                                         
                                                            █...█.█.█.█.█...█.....█.█...█.█.█...█...█                                                         
                                                             ████.███.█.███.███████.█.███.█.████ ██.█                                                         
                                                            █...█.█...█...█.......█.█.█...█.....█...█                                                         
                                                            █.█.█.█.███.█.███.███.█.███.███.███.█.██                                                          
                                                            █.█...█...█.█...█...█.█.....█.█...█.█.█.█                                                         
                                                            █.███████.███.█████.██ ██████.███.█.█.█.█                                                         
                                                            █...█...█...█.....█...█.........█.█.█.█.█                                                         
                                                            █.█.█.█.███.█████.███.█.███.█████.█.█.█.█                                                         
                                                            █.█...█.............█.....█.......█.....█                                                         
                                                             █ ███ █████████████ █████ ███████ █████                                                          
                                                                                                                                                              
                                                                                                                                                              
